1111111111111111
1CCC000CC010CCC1
1000C01001100101
10010001E0000101
10P0100000100001
1111111111111111