11111111111111111111111111111111111111111111111111111111111111111111111111111111111111111111111111111
10000000000000000000000000000000000000000000000000000000000000000000000000000000000000000000000000001
10000000000000000P00000000000000000000000000000000000000000000000000000000000000000000000000000000001
10000000000000000E00000000000000000000000000000000000000000000000000000000000000000000000000000000001
10000000000000000C00000000000000000000000000000000000000000000000000000000000000000000000000000000001
11111111111111111111111111111111111111111111111111111111111111111111111111111111111111111111111111111