11111111111111111111111111111111111111111111111111111111111111111111111
1111111P111111111111111111111111111111111111111111111111111111111111111
11000000000111111111111111111111111111111111111111111111111111111111111
10000CE0000111111111111111111111111111111111111111111111111111111111111
11111111111111111111111111111111111111111111111111111111111111111111111