1111111
1PPPPP1
11CE111
1111111