111111111
1PEC00001
111111111
