111111111111111111
1000000000000P0001
100000000000000001
1CCCCCCCCCCCC00001
111111111111111111