000000000000000000
000000000000000000
111111111111111111
100000000000000001
100000000000000P01
1CCCCCCCCCCCCE0001
111111111111111111