111111111111111111
100000000000000001
10000000000Q00P001
1CCCCCCCCCCCCE0001
111111111111111111