111111111111111111
1000000P0000011111
100000000000000001
1CCCCCCCCCCCCE0001
111111111111111111