111111111111111111
1CCCCCCCCP00000001
100000000000000001
1000000000000E0001
111111111111111111