111111111111111
1000P0000000001
1000000C0000001
100000000000001
10000000000E001
111111111111111