1111111111111111111111111111111
1111111111111111111111111111111
10P0000000000000000000000000111
1111111110000000000000000000011
100000CCCCCCC111111111110000011
1111110001110011001100110011001
111C111111111E11111100000000001
1110000011000001111111110001111
1001001000001000000000000000001
1111111111111111111111111111111