11111111111111111111111111111111
11111111111111111111111111111111
11111111111111111111111111111111
11111111111111111111111111111111
111111111111111111111P1111111111
11111111111111111111111111111111
1CCCCCCCCCCCCCCCCCCCCCCCCCCE0001
11111111111111111111111111111111