111111111111111111
100000000000000001
100000000000P00001
100000000C000E0001
111111111111111111